*****A*****
*        **
*  *    **B
*  * ** * *
*  * *  * *
*     *** *
****** ****
