A*              *B
*  ****   ***** *
*  *   *  *     *
*  *   *  * *** *
*  *   *  * *   *
*  *   *  * * * *
*  *   **** * * *
*  *         * * 
*  *********** * 
*              **
***************
