***A*
*   *
*   *
* * *
B   *
*****
