A*             *B
   *  	*   **** 
*  *   *  *     *
*  *   *  * *** *
*  *   *  * *   *
*  *   *  * * * *
*  *   * ** * * *
*  *         * * 
*  *********** * 
*              **
***************
