A                    *
 ****     ****      *B
     *     *     *** 
 **  * *   *  * *    
*  * * *   *  * *    
     * **  *  * **   
     *      *** * *  
 *     * *      * *  
 * **  * ** ***  * * 
