***B***
*  *  *
* *   *
*    **
*  *  *
A     *
*******
